| | | | |X[ | | | ] |X| | | |
|P|P| | |X[X| | | ] |X|O|O|O|
| | | | | [X|X|X| ] |X| | | |
| | | |X| [ |X|X|X] | | | | |
|O|O|O|X| [ | | |X]X| | |P|P|
| | | |X| [ | | | ]X| | | | |