|X| | | | [X| | | ] | | | |X|
|X| |X| | [X| | | ] | | | |X|
|P|P|X| | [X|X|X| ] | |X| | |
| | |X| | [ |X|X|X] | |X|P|P|
|X| | | | [ | | |X] | |X| |X|
|X| | | | [ | | |X] | | | |X|