| | | | | [ |O|O| ] | | | | |
| | | |X| [ | |X| ] |O|O| | |
|P|P|X|X| [ |X|X| ] |X|X| | |
| | |X|X| [ |X|X| ] |X|X|P|P|
| | |O|O| [ |X| | ] |X| | | |
| | | | | [ |O|O| ] | | | | |