| | | | | [ ]O]O] ] | | | | |
| | | |X| [ | |X| ] |O|O| | |
|1|1|X|X| [ |X|X| ] |X|X| | |
| | |X|X| [ |X|X| ] |X|X|2|2|
| | |O|O| [ |X| | ] |X| | | |
| | | | | [ [O[O[ ] | | | | |