| | | | |X[ ] ] ] ]X| | | | |
| | | |X|X[ | | | ]X| | | | |
|1|1| |X| [ |O|O| ] |X| | | |
| | | |X| [ |O|O| ] |X| |2|2|
| | | | |X[ | | | ]X|X| | | |
| | | | |X[ [ [ [ ]X| | | | |