| | | | |X[ | | | ]X| | | | |
| | | |X|X[ | | | ]X| | | | |
|P|P| |X| [ |O|O| ] |X| | | |
| | | |X| [ |O|O| ] |X| |P|P|
| | | | |X[ | | | ]X|X| | | |
| | | | |X[ | | | ]X| | | | |