| | | | | [ ] ] ] ] | | | | |
| | | | | [O|O|X|X] | | | | |
|1|1| | |X[X|X|X|X]X| | | | |
| | | | |X[X|X|X|X]X| | |2|2|
| | | | | [X|X|O|O] | | | | |
| | | | | [ [ [ [ ] | | | | |