| | |X| | [ | | | ]O|O|O| | |
|P|P|X| | [O|O| | ] | | | | |
| | |X| | [X| | |X] | | | | |
| | | | | [X| | |X] | |X| | |
| | | | | [ | |O|O] | |X|P|P|
| | |O|O|O[ | | | ] | |X| | |