| | |X| | [ ] ] ] ]O|O|O| | |
|1|1|X| | [O|O| | ] | | | | |
| | |X| | [X| | |X] | | | | |
| | | | | [X| | |X] | |X| | |
| | | | | [ | |O|O] | |X|2|2|
| | |O|O|O[ [ [ [ ] | |X| | |