| | | | | [ | | | ] | | | | |
| | | | | [ | | |X]O|O|O| | |
|P|P|X|X|X[X| | |X]X|X|X| | |
| | |X|X|X[X| | |X]X|X|X|P|P|
| | |O|O|O[X| | | ] | | | | |
| | | | | [ | | | ] | | | | |