| | | | | [ ] ] ] | | | | |
| | | | | [ | | ] | | | | |
|1|1| | | [ |X| ] | | | | |
| | | | | [ |X| ] | | |2|2|
| | | | | [ | | ] | | | | |
| | | | | [ [ [ ] | | | | |