| | | | |X[ ] ] ] ] |X| | | |
|1|1| | |X[X| | | ] |X|O|O|O|
| | | | | [X|X|X| ] |X| | | |
| | | |X| [ |X|X|X] | | | | |
|O|O|O|X| [ | | |X]X| | |2|2|
| | | |X| [ [ [ [ ]X| | | | |